FFFFFFFFFFFFFFFFFFWABAWW
F.L..LLLLLLLLL.LL...S..W
F.L..........L.LL......W
F.L..........L.LL......W
FLLL.LLLLLL..L.LL.....LW
F....L...L...L.L.L....LW
F....L...L..LLLLLL.....F
F....L...L.....LLLLLL..F
F....L...L.............F
Y....L....LLLLLLLLLLLLLF
F....L.................F
FFFFFFFFFFFFFFFFFFFFFFFF