WPWWWWWWWWWWWWWWWWWWWPWW
W.....D...D....W....W..W
WWWW..W...W.WW...WW....W
GS.WWWWWWWW.W.WWW..WWWWW
W......................W
W.WWWW.WWWW.WWWW.WWWW..X
W......................W
WWWDWWWWDWWWWDWWWW.....W
W....W....D......W....WW
W....W....WWWWWWWWWWWW.P
P....W....D............W
WWWWWWWWWWWWWWWWWWWWWWWW