WPWWWWWWNWWWWWWWWWWWWPWW
N.....D...D....W....W..W
WWWW..W...W.WW...WW....W
GS.WWWWWWWW.W.WWW..WWWWW
N......................W
W.WWWW.WWWW.WWWW.WWWW..X
W......................W
WWWDWWWWDWWWWDWWWW.....W
P....W....D......W....WW
W....W....WWWWWWWWWWWW.P
W....W....D............W
WWNWWWWNWWWWWWWWWWWWWWWW