WNWPWWWWNWWWPWWWWWWWWWWW
N...W.D......W.........X
W...D.W...WWWW.WWWWWWWWW
W...W.WWWWW....W.......W
WWWWW.....W.WWWW.W.....W
BS........W...D..W.....W
WWWWW.W...WWWWWWWWWWWWDW
W.....W................W
WDWWWWWWWWWWWWW.WWWWWWWW
P.....W.......D.W......W
W.....W.......W.D......W
WWNWWWWWWNWWWPWWWWWWWWWW