WWWWWWWW
W...W..X
WWWWW..U
BS.....W
WWWWW..E
W...W..Z
WWWWWWWW
WWWWWWWW