VVVVVVVVVVVVVVVVVVVVVVVV
BS.....................V
VVVVVVVVVVVVVVVVVVVVVV.V
V...VOOOVVVV.........V.V
V...O.......VVVVVVVVVV.V
V...2..................V
V...1..................V
V...O.......VVVVVVVVVVVV
V...VOOOXVVVV..........V
V.........V.VVVVVVVVVVVV
V.........V............V
VVVVVVVVVVVVVVVVVVVVVVVV