FWFWFWWWWWWWWWWW
W....W.F.......W
P..............F
W.W........PW..W
W.WWFW.....W...W
W..............W
W...S..F.......W
WWFWF.........FW
W...PW.........W
P..............F
W.W........PW..W
W.WWFW.....W...W
W..............W
W......F.......W
WWFWFFFFFFFFFFFW