WWWWWWWW
W.S....W
W......W
W.W..W.W
W.WWWW.W
W.W..W.W
W......W
WWWWWWWW