FFFFFFFFFFFFFFFFFFFFFFFF
F....LLLLLLLLL.L.......W
F............L.L.......A
F............L.L.......X
F....LLLLL...L.L.......A
F....L...L...L.L.......W
F....L...L...LLL.......W
F....L...L.............F
F....L...L.............F
GS...L....LLLLLLLLLLLLLF
F....L.................F
FFFFFFFFFFFFFFFFFFFFFFFF