FWFWFWWW
W....W.W
P......F
W......W
WWDWWWDW
W......W
W...S..W
WFFFFFFF