FFFFFFFFFFFFFFFFFFFFFFFF
F......................W
P......................W
F......................X
F......................W
F......................W
F......................W
F......................F
F......................F
GS.....................F
F......................F
FFFFFFFFFFFFFFFFFFFFFFFF